############
#  A       #
#  #  #    #
#  # ####  #
#    #@ #  #
#  ####    #
# A#    ####
#  #  #    #
#     #    #
#  #########
#  A       #
############